22222200000000000000000000000000000000000000000222n
22222200000000000000000000000000000000000000000222n
22222200000000000000000000000000000000000000000222n
22222200000000000000000000000000000000000000000222n
22222200000000000000000000000000000000000000000222n
22222200000000000000000000000000000000000000000222n
22222200000000000000000000000000000000000000000222n
22222200000000060000000000000000000000000000000222n
22222200000011111100000000000000000000000600000222n
22222200040000000000000000006000006000001111000222n
22222200111100000006005001111100000000000000000222n
22222200000000000111111000000000000006000000333122n
22222200000000000000000000005000600011111111111222n
22222222222222222222222222222222222222222222222222n
22222222222222222222222222222222222222222222222222n
22222222222222222222222222222222222222222222222222n
22222222222222222222222222222222222222222222222222n
22222222222222222222222222222222222222222222222222n
22222222222222222222222222222222222222222222222222n
222222222222222222222222222222222222222222222222222
