11111100000000000000000000000000000000000000000000000000000000000000000000111111n
11111100000000000000000000000000000000000000000000000000000000000000000000111111n
11111100000000000000000000000000000000000000000000000000000000000000000000111111n
11111100000000000000000000000000000000000000000000000000000000000000000000111111n
11111100000000000000000000000000000000000000000000000000000000000000000000111111n
11111100000000000000000000000000000000000000000000000000000000000000000000111111n
11111100000000000000000000000000000000000000000000000000000000000000000000111111n
11111100000000000000000000000000000000000000000000000000000000000000000000111111n
11111100000000000000000000000000000000000000000000000000000000000000000000111111n
11111100000000000000000000000000000000000222200000000000022222200000000000000111n
11111100000000000000000000000000000000000000000000222200000000000000000200000111n
11111100000000000000000000000000000003000000000000000000000000000000000000600111n
11111100000000000000000000004000000022222222222222222222222222222222222222222111n
11111111111111111111111111111111111111111111111111n
11111111111111111111111111111111111111111111111111n
11111111111111111111111111111111111111111111111111n
11111111111111111111111111111111111111111111111111n
11111111111111111111111111111111111111111111111111n
11111111111111111111111111111111111111111111111111n
111111111111111111111111111111111111111111111111111
