11111122222222222222222222222222222222222222111111
11111100000000000000000000000000000000000000111111
11111100000000000000000000030000000000000000111111
11111100000000000000000000222220000000000000111111
11111100000000030000000000000000000000000000111111
11111100000002222000000000000000000000222000111111
11111100000000000000000000000000000000000000111111
11111100000000000000000000000000000400030000111111
11111100000002222000000000000000000222222000111111
11111100000000000000400000000003000000000000111111
11111100000000000022222000000222220000000000111111
11111102222000000000000000000000000000000000111111
11111100000000030000000000000000000000400000111111
11111100000002222200000000400000000022222200111111
11111100000000000000000022222200000000000000111111
11111100000000000000000000000000000000000000111111
11111100000000000000000000000000300000040000111111
11111122222222222222222222222222222222222222111111
11111111111111111111111111111111111111111111111111
11111111111111111111111111111111111111111111111111


